*+*+*+*+*+*+*
+           +
* *+*+*+*+*+*
+   + +   + +
* *+* *+* * *
+ +     + + +
*+* *+*+* *+*
+   +   +   +
*+*+* *+*+*+*