* *+*+*+*+*+*+*+* *
+ +       + +   + +
*+*+*+*+* * *+* *+*
  +     + + +     +
*+* *+*+* * * *+* *
  +       + + +   +
* *+*+* *+* *+* * *
+ + + + +       + +
*+* * * *+* *+*+* *
+ + + +   + + + + +
* * * * *+*+* * * *
+ + +         +
* * *+*+*+*+* *+* *
+       +     +   +
*+*+*+* *+* *+*+*+*
  +   +           +
*+* *+*+*+*+*+*+*+*
  +     +     +
*+*+*+* *+*+* *+*+*